         SO    ./grr/palumbofinito.xpm
C 0,0,255
WE ./grr/pal.xpm
    			 	 	NO              				 		./grr/jfazi.xpm
EA ./grr/tpenalba_1.xpm
F 250,255,0



1111111111111111111111111
1000000000110000000000001
1011000001110000000000001
10010000000000000000000011111111
1111111110110000011100000000N0001
10000000001100000111011111111111
11110111111111011100000010001
11110111111111011101010010001
11001000110101011100000000001
100100000000000001100000000001
10001000000000001101010000001
1100000111010101111101111000111
11110111 1110101 101111010001
11111111 1111111 111111111111



